1111111111111111111111111111111
1E0000000000000C00000C000000001
1110010100100000101001000010101
1000000001000000001000000000001
1100010010101010001001000010101
1P0000000C00C0000000000000000C1
1111111111111111111111111111111