1111111
10000E1
1110111
1C000P1
1111111