1111111
10000E1
1111011
1C000P1
1111111