111111111
1P0000001
101111101
1C0000C01
100011E01
111111111