111111111111111
1P0000000010001
101111111101111
1C00000000000C1
101011111110101
1C01000000010C1
101011111110101
1C0000C00000E01
101111111111101
111111111111111