11111111111111111
100EP0001C0000001
10000MC0000000001
10001000010000001
10001000011000001
11111111111111111