1111111111111
100100100C001
1000111110001
10P011000E001
1111111111111