1111111111111
10010000C0001
1000111110001
1P0011000E001
1111111111111